NO ./textures/north_texture.png
SO ./textures/south_texture.png
WE ./textures/west_texture.png
EA ./textures/east_texture.png

C 255,255,120           
F 218,177,218              

1111111111111111111
1000000000000000001
1000000000000000001
1000000001000000001
1000000000000000001
1000000000000000001
100000000N000000001
1000000000000000001
1111111111111111111