NO                        ./textures/north.png

C                            155,100,255            

SO         ./textures/south.png

WE                             ./textures/west.png

F                                   183,232,233               

EA                                      ./textures/east.png

1111111111111111111111
1000000000000000000001
1000000000000000000001
1000001111000000000001
1000000000000000000001
1000000000N00000000001
1000000000000000000001
1000000000000000000001
1111111111111111111111