NO                        ./path_to_the_north_texture

C                            225,30,0            

SO         ./path_to_the_south_texture

WE                             ./path_to_the_west_texture

F                                   220,100,0                

EA                                      ./path_to_the_east_texture

1111111111111111111111
1000000000000000000001
1000000000000000000001
1000001111000000000001
1000000000000000000001
1000000000N00000000001
1000000000000000000001
1000000000000000000001
1111111111111111111111