NO ./textures/wood.png
SO ./textures/rivet.png
WE ./textures/hazard.png
EA ./textures/grid.png
C 148,201,140
F 209,199,205



1111111111111111111
10000001  100000001
1N1111111111111111
111