


NO                        ./textures/spiderman.png

C                            155,100,255            

SO         ./textures/bart.png

WE                             ./textures/spiderman.png

F                                   70,10,255                

EA                                      ./textures/bart.png



111111111111111111
100000000001000001
1000000000000000N1
100000000000000001
111111111111111111
