


NO                        ./textures/south.png

C                            155,100,255            

SO         ./textures/bart.png

WE                             ./textures/spiderman.png

F                                   70,10,255                

EA                                      ./textures/bart.png



111111111111111111         
100000000001000001         
10000E000000000001111111111
100000000000000000000000001
111111111111111110000000001
111111111111111110000000001
111111111111111111111111111
