


NO                        ./textures/north.png

C                            255,11,00255            

SO         ./textures/south.png

WE                             ./textures/west.png

F                                   109,100,055                

EA                                      ./textures/east.png






1111111111111111111111111111111
10000000000000000000000000000111111111111111111111111111111111111111111111111111111111111111111111111111111111111111111
100000000000000000000E000000000000000000000000000000000000000000000000000000000000000000000000000000000000000000000001
1000000000000000000000000000001000000000000000000000000000000000000000000000000000000000000000000000000000000000000111
111111011111111111111111111111111111111111111111111111111111111111111111111111111111111111111111111111111111111111111
1000000000001
1000000000001111111111111111111
1000000000000000000000000000001
1000000000000000000000000000001
1000000000000000000000000000001
1111111111111111111100000000001
                   100000000001
                   100000000001
                   100000000001
                   100000000001
1111111111111111111100000000001
1000000000000000000000000000001
1000000000000000000000000000001
1000000000000000000000000000001
1111111011111111111111111111111
1000000000001
1000000000001111111111111111111
1000000000000000000000000000001
1000000000000000000000000000001
1000000000000000000000000000001
1111111111111111111100000000001
                   100000000001
                   100000000001
                   100000000001
                   100000000001
1111111111111111111100000000001
1000000000000000000000000000001
1000000000000000000000000000001
1000000000000000000000000000001
1000000000001111111111111111111
1000000000001
1111111011111111111111111111111
1000000000000000000000000000001
1000000000000000000000000000001
1000000000000000000000000000001
1111111111111111111100000000001
                   100000000001
                   100000000001
                   100000000001
                   100000000001
1111111111111111111100000000001
1000000000000000000000000000001
1000000000000000000000000000001
1000000000000000000000000000001
1111111111111111111111111111111
