


NO                        ./textures/spiderman.png

C                            255,30,0            

SO         ./textures/bart.png

WE                             ./textures/spiderman.png

F                                   24,100,1                

EA                                      ./textures/bart.png



		11111111111111111111111111				11111111111
		11000000000110000000000001				10000000001
		1011000001110000000000001N				11111111111
		100100000000000000000000111111111
		111111111011000001110000000000001
		100000000011000011101111111111111
		11110111111111011100000010001
		11110111111111011101010010001
		11000000110101011100000010001
		10000000000000001100000010001
		10000000000000001101010010001
		110000011101010111110111100111
		11110111 11101011 1111010N011
		11111111 11111111 111111111