


NO                        ./textures/spiderman.png

C                            155,30,0            

SO         ./textures/bart.png

WE                             ./textures/spiderman.png

F                                   14,100,1                

EA                                      ./textures/bart.png



111111111111111111
100000000000000001
100000N00000000001
100000000000000001
111111111111111111
